"player","team","mp_g","mp_g_star","min_diff","rating"
"Napheesa Collier","MIN",32,36,4,100
"A'ja Wilson","LVA",28,36,8,96
"Aliyah Boston","IND",31,36,5,95
"Allisha Gray","ATL",39,36,-3,94
"Alyssa Thomas","PHO",26,33,7,92
"Breanna Stewart","NYL",0,0,0,92
"Nneka Ogwumike","SEA",28,36,8,90
"Azura Stevens","LAS",28,36,8,89
"Brionna Jones","ATL",30,37,7,89
"Dearica Hamby","LAS",31,33,2,88
"Jackie Young","LVA",28,33,5,88
"Kelsey Mitchell","IND",32,33,1,88
"Ezi Magbegor","SEA",26,33,7,88
"Sabrina Ionescu","NYL",37,36,-1,88
"Sonia Citron","WAS",33,36,3,87
"Skylar Diggins","SEA",29,29,0,87
"Gabby Williams","SEA",31,26,-5,87
"Paige Bueckers","DAL",30,33,3,87
"Kayla McBride","MIN",32,32,0,87
"Alanna Smith","MIN",27,27,0,87
"Courtney Williams","MIN",29,37,8,87
"Kelsey Plum","LAS",35,29,-6,86
"Natasha Cloud","NYL",34,37,3,86
"Veronica Burton","GSV",31,36,5,85
"Jonquel Jones","NYL",29,32,3,85
"Rhyne Howard","ATL",0,0,0,85
"Naz Hillmon","ATL",24,32,8,83
"Natasha Mack","PHO",14,30,16,82
"Leonie Fiebich","NYL",31,27,-4,82
"Satou Sabally","PHO",22,27,5,81
"DeWanna Bonner","PHO",21,24,3,81
"Natasha Howard","IND",25,29,4,81
"Bridget Carleton","MIN",29,23,-6,81
"Jessica Shepard","MIN",18,18,0,81
"Jordin Canada","ATL",29,27,-2,80
"Kayla Thornton","GSV",0,0,0,80
"Kennedy Burke","NYL",0,0,0,80
"Kiki Iriafen","WAS",27,37,10,79
"Temi Fagbenle","GSV",25,33,8,78
"Lexie Hull","IND",27,26,-1,78
"Aari McDonald","IND",27,22,-5,78
"Angel Reese","CHI",36,36,0,77
"Tiffany Hayes","GSV",27,29,2,77
"Brittney Sykes","WAS",32,32,0,77
"Sophie Cunningham","IND",25,18,-7,77
"Li Yueru","DAL",19,30,11,77
"Monique Billings","GSV",0,0,0,77
"Monique Akoa Makani","PHO",17,18,1,76
"Sami Whitcomb","PHO",22,21,-1,76
"Chelsea Gray","LVA",28,29,1,76
"Shakira Austin","WAS",23,27,4,75
"Erica Wheeler","SEA",26,22,-4,75
"Kalani Brown","PHO",9,15,6,74
"Olivia Nelson-Ododa","CON",21,33,12,74
"Kamilla Cardoso","CHI",28,37,9,74
"NaLyssa Smith","LVA",20,26,6,74
"Brittney Griner","ATL",25,23,-2,74
"Natisha Hiedeman","MIN",18,14,-4,74
"Ariel Atkins","CHI",0,0,0,74
"Kathryn Westbeld","PHO",18,12,-6,73
"Iliana Rupert","GSV",19,26,7,73
"Sug Sutton","WAS",26,23,-3,73
"Jewell Loyd","LVA",27,22,-5,73
"Luisa Geiselsoder","DAL",15,27,12,73
"Arike Ogunbowale","DAL",29,24,-5,73
"Nyara Sabally","NYL",0,0,0,73
"Cecilia Zandalasini","GSV",17,22,5,72
"Isabelle Harrison","NYL",12,23,11,72
"Caitlin Clark","IND",0,0,0,72
"Tyasha Harris","DAL",0,0,0,72
"Jacy Sheldon","CON",23,30,7,71
"Laeticia Amihere","GSV",14,18,4,71
"Teaira McCowan","DAL",9,21,12,71
"Rebekah Gardner","NYL",14,18,4,71
"Marine Johannes","NYL",22,14,-8,71
"Te-Hina PaoPao","ATL",14,18,4,71
"Maria Kliundikova","MIN",8,9,1,71
"Kahleah Copper","PHO",16,9,-7,70
"Rachel Banham","CHI",26,32,6,70
"Maddy Siegrist","DAL",18,15,-3,70
"Haley Jones","DAL",14,18,4,70
"Courtney Vandersloot","CHI",0,0,0,70
"Lexi Held","PHO",15,6,-9,69
"Julie Allemand","LAS",24,26,2,69
"Diamond Miller","MIN",9,5,-4,69
"Aaliyah Edwards","WAS",0,0,0,69
"Rae Burrell","LAS",15,18,3,68
"Emma Cannon","LAS",8,22,14,68
"Tina Charles","CON",26,27,1,68
"Elizabeth Williams","CHI",22,27,5,68
"Emily Engstler","WAS",10,14,4,68
"Lucy Olsen","WAS",10,18,8,68
"Makayla Timpson","IND",5,15,10,68
"JJ Quinerly","DAL",12,12,0,68
"Maya Caldwell","ATL",16,14,-2,68
"Kitija Laksa","PHO",18,3,-15,67
"Leïla Lacan","CON",18,24,6,67
"Carla Leite","GSV",16,15,-1,67
"Alysha Clark","SEA",17,15,-2,67
"Dominique Malonga","SEA",9,18,9,67
"Myisha Hines-Allen","DAL",17,6,-11,67
"Aziaha James","DAL",14,9,-5,67
"Nia Coffey","ATL",11,9,-2,67
"Karlie Samuelson","MIN",0,0,0,67
"Aneesah Morrow","CON",14,21,7,66
"Kaitlyn Chen","GSV",11,11,0,66
"Janelle Salaün","GSV",24,7,-17,66
"Kierstan Bell","LVA",7,18,11,66
"Dana Evans","LVA",17,15,-2,66
"Damiris Dantas","IND",12,11,-1,66
"Shatori Walker-Kimbrough","ATL",12,5,-7,66
"Rayah Marshall","CON",3,18,15,65
"Kate Martin","GSV",16,4,-12,65
"Stefanie Dolson","WAS",16,5,-11,65
"Jade Melbourne","WAS",24,9,-15,65
"Aaliyah Nye","LVA",16,7,-9,65
"Kiah Stokes","LVA",15,11,-4,65
"Lexie Brown","SEA",7,11,4,65
"Jaylyn Sherrod","NYL",5,9,4,65
"Stephanie Talbot","NYL",16,5,-11,65
"Sania Feagin","LAS",2,11,9,64
"Julie Vanloo","LAS",12,15,3,64
"Bria Hartley","CON",21,15,-6,64
"Saniya Rivers","CON",23,12,-11,64
"Rebecca Allen","CHI",24,23,-1,64
"Sydney Colson","IND",14,4,-10,64
"Brianna Turner","IND",2,7,5,64
"Michaela Onyenwere","CHI",16,14,-2,63
"Maddy Westbeld","CHI",7,18,11,63
"Zia Cooke","SEA",9,7,-2,63
"DiJonai Carrington","DAL",22,3,-19,63
"Rickea Jackson","LAS",30,7,-23,62
"Kia Nurse","CHI",26,9,-17,62
"Megan Gustafson","LVA",14,4,-10,62
"Lindsay Allen","CON",12,9,-3,61
"Haley Peters","CON",12,6,-6,61
"Hailey Van Lith","CHI",15,5,-10,61
"Tiffany Mitchell","SEA",19,4,-15,61
"Sarah Ashlee Barker","LAS",14,4,-10,60
"Marina Mabrey","CON",27,3,-24,60
